5
1500 225 150 0 1 70 70 0
1500 450 150 0 1 70 70 0
1500 675 150 0 1 70 70 0
1300 300 150 0 1 70 70 0
1300 600 150 0 1 70 70 0