7
1500 225 200 2 1 60 60 1
1500 450 200 2 1 60 60 -1
900 675 200 2 1 60 60 1
1300 300 200 2 1 60 60 1
1300 600 200 2 1 60 60 -1
1100 100 200 2 1 60 60 -1
1100 550 200 2 1 60 60 1